210,216,216,216,214,216,216,216,211,
208,248,248,248,208,248,248,248,208,
208,248,248,248,208,248,248,248,208,
208,248,248,248,208,248,248,248,208,
221,216,216,216,215,216,216,216,222,
208,248,248,248,208,248,248,248,208,
208,248,310,248,208,248,248,248,208,
208,248,248,248,208,248,248,248,208,
218,216,216,216,213,216,216,216,219,
