194,200,200,200,198,200,200,200,195,
192,307,307,307,192,307,307,307,192,
192,307,307,307,192,307,307,307,192,
192,307,307,307,192,307,307,307,192,
205,200,200,200,198,200,200,200,206,
192,307,307,307,192,307,307,307,192,
192,307,334,307,192,307,307,307,192,
192,307,307,307,192,307,307,307,192,
205,200,200,200,197,200,200,200,206,
