178,184,184,184,182,184,184,184,179
176,5,5,5,176,5,5,5,176
176,5,5,5,176,5,5,5,176
176,5,5,5,176,5,5,5,176
189,184,184,184,183,184,184,184,190
176,5,5,5,176,5,5,5,176
176,5,310,5,176,5,5,5,176
176,5,5,5,176,5,5,5,176
186,184,184,184,181,184,184,184,187
